21010101010101010101012
0k00000k000k000k00000k0
20232041010301014023202
000p000f0f0f0f0f000p000
20030001010101010003002
0k00000k000k000k00000k0
20230120210001202103202
000f0f00000000000f0f000
2003202k2000002k2023002
0k000f00000000000f000k0
41404040010101004040414
0f000f0k000k000k0f000f0
21000100212021200100012
0k000k00000000000k000k0
20232023014041032023202
000f000f0f000f0f000f000
2k202k20210k01202k202k2
000f000f0000000f000f000
20030020202120202003002
0k000k0f000f000f0k000k0
20232003000300030023202
000p000k000k000k000p000
20030041010301014003002
0k000k0f0f0f0f0f0k000k0
01010101010101010101010